Block_Size_MB,Block_Dim_0,Block_Dim_1,Write_Time_ms,Read_Time_ms,Total_Time_ms
16KB,4,1024,3089,3138,6227
64KB,16,1024,3506,3059,6565
256KB,64,1024,3153,3029,6182
1MB,256,1024,3164,3035,6199
4MB,1024,1024,3759,3081,6840
16MB,4096,1024,2972,3088,6060
64MB,16384,1024,2963,3129,6092
256MB,65536,1024,2999,3544,6543
1024MB,262144,1024,3173,4308,7481
2048MB,524288,1024,2960,5500,8460
