Block_Size_MB,Block_Dim_0,Block_Dim_1,Write_Time_ms,Read_Time_ms,Total_Time_ms
16KB,4,1024,3006,3060,6066
64KB,16,1024,2968,3022,5990
256KB,64,1024,3015,3162,6177
1MB,256,1024,3049,3381,6430
4MB,1024,1024,3512,3078,6590
16MB,4096,1024,2931,3098,6029
64MB,16384,1024,2924,3118,6042
256MB,65536,1024,2980,3364,6344
1024MB,262144,1024,2946,4321,7267
2048MB,524288,1024,2945,5450,8395
