Block_Size_MB,Block_Dim_0,Block_Dim_1,Write_Time_ms,Read_Time_ms,Total_Time_ms
16KB,4,1024,3442,3198,6640
64KB,16,1024,3079,3159,6238
256KB,64,1024,3468,3301,6769
1MB,256,1024,3187,3203,6390
4MB,1024,1024,3040,3154,6194
16MB,4096,1024,3018,3161,6179
64MB,16384,1024,3158,3294,6452
256MB,65536,1024,3097,3490,6587
1024MB,262144,1024,3046,4435,7481
2048MB,524288,1024,2987,5765,8752
