Block_Size_MB,Block_Dim_0,Block_Dim_1,Write_Time_ms,Read_Time_ms,Total_Time_ms
16KB,4,1024,3001,3068,6069
64KB,16,1024,2955,3042,5997
256KB,64,1024,2950,3010,5960
1MB,256,1024,2931,3019,5950
4MB,1024,1024,2979,3053,6032
16MB,4096,1024,2892,3029,5921
64MB,16384,1024,2901,3647,6548
256MB,65536,1024,2910,3346,6256
1024MB,262144,1024,2889,4256,7145
2048MB,524288,1024,3015,5544,8559
