Block_Size_MB,Block_Dim_0,Block_Dim_1,Write_Time_ms,Read_Time_ms,Total_Time_ms
16KB,4,1024,2982,3048,6030
64KB,16,1024,2863,3006,5869
256KB,64,1024,2888,3520,6408
1MB,256,1024,2912,3328,6240
4MB,1024,1024,2891,3486,6377
16MB,4096,1024,2984,3104,6088
64MB,16384,1024,2931,3227,6158
256MB,65536,1024,2916,3395,6311
1024MB,262144,1024,2917,4464,7381
2048MB,524288,1024,2953,5535,8488
